#       #
#S##### #
# #   # #
# # # # #
# # #   #
# # #   #
# # #   #
# # #   #
# # #   #
# # #   #
#   #   #
#####   #
#E      #
##      #